11111111
100E0001
11100P01
1C000001
11111111
