11111111111111
10000001100001
10111101100001
10000000000001
10011111E11111
11011000110111
100000100000P1
11111111111111
