111111111111111111111111111111111111111111111
1C0000CCCC000000000C000000C111101100000000CC1
1000101000X00001C0011000010000000000001000001
100011100100000100011C00010000000X11000100101
1P000E110000000CCC01000C000011C11CCCC11CCCCC1
1C00100CCC010000000C0000000111111100000000001
1000101000000001C0011000010000000000001C00001
1C0000C1CC010100000C00X0100110C11100000000CC1
1000101000010011C0011000010000000000001000001
1C00C00CXC0000C1000C00C0000111111100000000C01
1000101000110001C00110000100001C000000100C001
111111111111111111111111111111111111111111111
