111111111111111111111111111111111
1P0000000000000000000000000000001
1000000CCXCCC000000CCCCCC00000001
100000C000000C0000C000000C0000001
10000C00000000C00C00000000C000001
10000C000000000CC0000000000X00001
100000C0000000000000000000C000001
1000000C00000001110000000C0000001
10000000X0000001E1000000C00000001
100000000C0000010100000C000000001
1000000000C00001010000C0000000001
10000000000C000101000X00000000001
100000000000C0010100C000000000001
1000000000000C01010C0000000000001
10000000000000X101C00000000000001
100000000000000CCC000000000000001
111111111111111111111111111111111
