11111111111
1E0C0000P11
11111111111